{
  "date": "2026-02-02",
  "timestamp": "2026-02-02T08:00:00",
  "practices": {
    "live": 18,
    "waitlist": 58,
    "pipeline": 76,
    "total": 6358,
    "coverage_pct": 1.2
  },
  "patients": {
    "live": 120000,
    "waitlist": 350000,
    "pipeline": 470000
  },
  "live_ods": [
    "C83626",
    "E82014",
    "E82084",
    "E82661",
    "E84076",
    "E85013",
    "E85034",
    "E85051",
    "E85069",
    "E85129",
    "F85071",
    "G82014",
    "H85055",
    "J82007",
    "L81051",
    "L82039",
    "P84056",
    "Y02842"
  ],
  "waitlist_ods": [
    "A81019",
    "A81038",
    "A87005",
    "B82054",
    "B82628",
    "B85016",
    "C81018",
    "C81061",
    "C82035",
    "C82046",
    "C84696",
    "D81043",
    "D82070",
    "E82013",
    "E84003",
    "E84656",
    "F83003",
    "F85023",
    "F85039",
    "F85043",
    "F85654",
    "F86607",
    "G81052",
    "G82051",
    "G82079",
    "G82088",
    "G82122",
    "G82666",
    "G83002",
    "G83009",
    "G83028",
    "H81642",
    "H84042",
    "H85037",
    "H85110",
    "J82058",
    "J82138",
    "J82161",
    "K81075",
    "K84046",
    "K84055",
    "K84056",
    "L82045",
    "L85024",
    "M83027",
    "M83035",
    "M83042",
    "M83681",
    "M83718",
    "M85029",
    "M88042",
    "N81070",
    "P81032",
    "P81170",
    "P81196",
    "P89008",
    "Y00078",
    "Y00560"
  ]
}