{
  "date": "2026-02-16",
  "timestamp": "2026-02-16T08:00:00",
  "practices": {
    "live": 28,
    "waitlist": 78,
    "pipeline": 106,
    "total": 6358,
    "coverage_pct": 1.67
  },
  "patients": {
    "live": 190000,
    "waitlist": 470000,
    "pipeline": 660000
  },
  "live_ods": [
    "C82096",
    "C83626",
    "E82014",
    "E82084",
    "E82099",
    "E82661",
    "E84076",
    "E85013",
    "E85014",
    "E85034",
    "E85046",
    "E85051",
    "E85069",
    "E85075",
    "E85129",
    "F83005",
    "F85071",
    "G82014",
    "H82066",
    "H85055",
    "J82007",
    "J82154",
    "K82016",
    "L81051",
    "L82039",
    "P84038",
    "P84056",
    "Y02842"
  ],
  "waitlist_ods": [
    "A81019",
    "A81038",
    "A87005",
    "A87006",
    "B82054",
    "B82628",
    "B85016",
    "C81018",
    "C81061",
    "C82035",
    "C82046",
    "C84696",
    "C87017",
    "D81043",
    "D82070",
    "E81057",
    "E82013",
    "E83649",
    "E84003",
    "E84656",
    "F83003",
    "F85013",
    "F85023",
    "F85039",
    "F85043",
    "F85634",
    "F85654",
    "F86607",
    "G81052",
    "G82051",
    "G82079",
    "G82088",
    "G82122",
    "G82666",
    "G82809",
    "G83002",
    "G83009",
    "G83028",
    "H81642",
    "H82621",
    "H84042",
    "H85037",
    "H85110",
    "J82010",
    "J82058",
    "J82138",
    "J82161",
    "K81075",
    "K81657",
    "K83069",
    "K84046",
    "K84055",
    "K84056",
    "L82045",
    "L85024",
    "M83013",
    "M83027",
    "M83035",
    "M83042",
    "M83073",
    "M83680",
    "M83681",
    "M83718",
    "M85001",
    "M85029",
    "M88015",
    "M88042",
    "M92607",
    "N81070",
    "P81032",
    "P81170",
    "P81196",
    "P81731",
    "P88007",
    "P89008",
    "Y00078",
    "Y00560",
    "Y03402"
  ]
}